8 9
X X X X X X X X X
X . . . X X . X X
X . X . X X X X X
X . X . . . . X X
X . X . X . X X X
X . X . X . X X X
X . X . . . X X X
X X . . X X X X X