8 8
X X X X X X X X
X . . . X X . X
X . X . X X . X
X . X . . . . X
X . X . X . X X
X . X . X . X X
X . X . . . X X
X X X X X X X X